,date,total_confirmed,new_confirmed,new_confirmed_after_fft,total_deaths,new_deaths,new_death_after_fft,total_recovered
0,2020-04-13,580526,25255,81196.08542364687,23909,1542,2234.2604167275317,23909
1,2020-04-14,607220,26694,70881.87588546642,26236,2327,2320.13140013559,26236
2,2020-04-15,636538,29318,60576.76972795496,28710,2474,2389.8459104252056,28710
3,2020-04-16,667773,31235,50718.51984077463,33317,4607,2441.1955733212344,33317
4,2020-04-17,699948,32175,41705.752158718016,37182,3865,2472.6949417572728,37182
5,2020-04-18,732511,32563,33872.65600786893,39045,1863,2483.6853803000017,39045
6,2020-04-19,759150,26639,27468.785946692456,41093,2048,2474.3939736161296,41093
7,2020-04-20,784339,25189,22645.403909208617,42601,1508,2445.940900615715,42601
8,2020-04-21,812350,28011,19449.257850435733,44889,2288,2400.292142262927,44889
9,2020-04-22,841392,29042,17824.09582626032,47083,2194,2340.158256327809,47083
10,2020-04-24,869377,27985,17619.602348470456,50373,3290,2268.843960754071,50373
11,2020-04-25,905402,36025,18606.867466000123,52377,2004,2190.0570973820004,52377
12,2020-04-26,938961,33559,20499.005254949105,54211,1834,2107.688879269028,54211
13,2020-04-27,966314,27353,22975.166622106306,55409,1198,2025.5798665043496,55409
14,2020-04-28,988946,22632,25705.97010252848,56804,1395,1947.2876309432743,56804
15,2020-04-29,1013567,24621,28378.319126146293,58899,2095,1875.8724005311997,58899
16,2020-04-30,1040857,27290,30717.686270886476,61380,2481,1813.7160528591337,61380
17,2020-05-01,1070356,29499,32506.21140866632,63277,1897,1762.3876909255116,63277
18,2020-05-02,1104673,34317,33595.355675565166,65243,1966,1722.5658189238288,65243
19,2020-05-03,1134034,29361,33912.3407515735,66832,1589,1694.0230720550067,66832
20,2020-05-04,1159488,25454,33460.13979204115,68222,1390,1675.6748473478417,68222
21,2020-05-05,1181551,22063,32311.326010876637,69480,1258,1665.6883894815048,69480
22,2020-05-06,1205503,23952,30596.581666682432,71531,2051,1661.6442867697206,71531
23,2020-05-07,1229579,24076,28489.083064918173,73743,2212,1660.7382994384293,73743
24,2020-05-08,1258201,28622,26186.273357967602,75961,2218,1660.008307016721,75961
25,2020-05-09,1285666,27465,23890.69245276177,77499,1538,1656.5691877895292,77499
26,2020-05-10,1310850,25184,21791.542808766208,79097,1598,1647.8378032453395,79097
27,2020-05-11,1330729,19879,20048.534995595408,79924,827,1631.7310196644362,79924
28,2020-05-12,1348818,18089,18779.293715145242,81106,1182,1606.8218088732308,81106
29,2020-05-13,1370968,22150,18051.240481530946,82766,1660,1572.4417709172885,82766
30,2020-05-14,1391857,20889,17878.43834730321,84471,1705,1528.7226540151028,84471
31,2020-05-15,1418584,26727,18223.42688529416,86251,1780,1476.5742741707943,86251
32,2020-05-16,1443775,25191,19003.633216821552,87873,1622,1417.601269731305,87873
33,2020-05-17,1468910,25135,20101.555889250754,89082,1209,1353.965957442665,89082
34,2020-05-18,1488414,19504,21377.6156732858,89955,873,1288.2087935244724,89955
35,2020-05-19,1509913,21499,22684.37506485551,90786,831,1223.0412409902408,90786
36,2020-05-20,1530024,20111,23880.760046670126,92253,1467,1161.1279346643348,92253
37,2020-05-21,1553138,23114,24844.975558516235,93749,1496,1104.8757492415418,93749
38,2020-05-22,1578654,25516,25484.980774716176,94980,1231,1056.246658199178,94980
39,2020-05-23,1602533,23879,25745.6620221558,96215,1235,1016.6091858185018,96215
40,2020-05-24,1623749,21216,25612.182064705896,97286,1071,986.6399776973416,97286
41,2020-05-25,1644754,21005,25109.36109065195,97933,647,966.2828220847547,97933
42,2020-05-26,1663783,19029,24297.321306985905,98472,539,954.7676955608283,98472
43,2020-05-27,1681653,17870,23263.96881258937,99146,674,950.6874781633209,99146
44,2020-05-28,1700901,19248,22115.162805864835,100622,1476,952.1252934959997,100622
45,2020-05-29,1722836,21935,20963.609476802434,101727,1105,956.821365042579,101727
46,2020-05-30,1747537,24701,19917.601334742176,102883,1156,962.365172754254,102883
47,2020-05-31,1772194,24657,19070.697482514774,103851,968,966.3967936647248,103851
48,2020-06-01,1792222,20028,18493.311973115095,104490,639,966.8007636714492,104490
49,2020-06-02,1812567,20345,18226.9608883638,105250,760,961.8766369538419,105250
50,2020-06-03,1833600,21033,18281.637057037995,106203,953,950.472560454794,106203
51,2020-06-04,1853454,19854,18636.462846345785,107203,1000,932.0714305197171,107203
52,2020-06-05,1874901,21447,19243.44745613277,108226,1023,906.8232728622232,108226
53,2020-06-06,1904778,29877,20033.876645049324,109345,1119,875.5220346890535,109345
54,2020-06-07,1927657,22879,20926.61771851602,110043,698,839.5296121161904,110043
55,2020-06-08,1946420,18763,21837.453114076154,110503,460,800.6542670832434,110503
56,2020-06-09,1962955,16535,22688.47656296617,110974,471,760.9942562490344,110974
57,2020-06-10,1980951,17996,23416.602226242598,111930,956,722.7602008325496,111930
58,2020-06-11,2002468,21517,23980.345783295063,112833,903,688.0912574399587,112833
59,2020-06-12,2024536,22068,24364.22483661763,113680,847,658.8803945852201,113680
60,2020-06-13,2050705,26169,24580.374432913264,114523,843,636.6230376837211,114523
61,2020-06-14,2076261,25556,24667.256839184927,115250,727,622.301125992114,115250
62,2020-06-15,2095980,19719,24685.63490298182,115580,330,616.3114360735964,115580
63,2020-06-16,2114522,18542,24712.24713891047,115976,396,618.4431550480714,115976
64,2020-06-17,2138450,23928,24831.844408003657,116764,788,627.9054738575096,116764
65,2020-06-18,2165690,27240,25128.401917444084,117523,759,643.4017801995523,117523
66,2020-06-19,2193639,27949,25676.392337896636,118220,697,663.2432185300136,118220
67,2020-06-20,2225545,31906,26532.99026696741,118877,657,685.491267623462,118877
68,2020-06-21,2258729,33184,27731.97773880501,119452,575,708.1168160175005,119452
69,2020-06-22,2285119,26390,29279.94582376796,119734,282,729.1621573997708,119734
70,2020-06-23,2316448,31329,31155.156418976516,120145,411,746.892447700595,120145
71,2020-06-24,2352802,36354,33309.16415042479,120865,720,759.9244263510419,120865
72,2020-06-25,2389361,36559,35671.02687564985,121614,749,767.32247092223,121614
73,2020-06-26,2429872,40511,38153.68098692169,124046,2432,768.6551078702406,124046
74,2020-06-27,2476031,46159,40661.8488347698,124681,635,764.0086594455908,124681
75,2020-06-28,2518210,42179,43100.69995383906,125177,496,753.9584474258668,125177
76,2020-06-29,2560322,42112,45384.41892185814,125484,307,739.5015688441495,125484
77,2020-06-30,2600073,39751,47443.84663711329,125810,326,721.9583982829288,125810
78,2020-07-01,2647344,47271,49232.45655007435,127028,1218,702.8523936642968,127028
79,2020-07-02,2698355,51011,50730.0931590466,127675,647,683.7792951241807,127675
80,2020-07-03,2753200,54845,51944.12035179365,128396,721,666.2773016870387,128396
81,2020-07-04,2807591,54391,52907.88030736479,129080,684,651.7092728459893,129080
82,2020-07-05,2856101,48510,53676.62503246373,129357,277,641.1665085854121,129357
83,2020-07-06,2905667,49566,54321.32695167969,129660,303,635.4013718280579,129660
84,2020-07-07,2951700,46033,54920.97886981073,130011,351,634.7931588296502,130011
85,2020-07-08,3010611,58911,55554.13768792135,131133,1122,639.3484681004851,131133
86,2020-07-09,3069884,59273,56290.536960780206,131929,796,648.7341593361521,131929
87,2020-07-10,3130601,60717,57183.58432922828,132946,1017,662.3381160970143,132946
88,2020-07-11,3198477,67876,58264.472326294985,133750,804,679.3506826687636,133750
89,2020-07-12,3259867,61390,59538.47382807792,134495,745,698.8580351218245,134495
90,2020-07-13,3320746,60879,60983.78190626177,134934,439,719.9379960654588,134934
91,2020-07-14,3378091,57345,62553.00855087787,135356,422,741.7489574613425,135356
92,2020-07-15,3445031,66940,64177.20129716716,136230,874,763.6035976591971,136230
93,2020-07-16,3512940,67909,65771.99567889636,137170,940,785.0208503434693,137170
94,2020-07-17,3588855,75915,67245.31761518886,138131,961,805.7519206965931,138131
95,2020-07-18,3660987,72132,68505.90261410802,139020,889,825.7788158562352,139020
96,2020-07-19,3725787,64800,69471.82184419569,139893,873,845.2866046733058,139893
97,2020-07-20,3787931,62144,70078.20570739957,140331,438,864.61318603671,140331
98,2020-07-21,3847580,59649,70283.43315768574,140717,386,884.1824879465813,140717
99,2020-07-22,3913634,66054,70073.20193337685,141795,1078,904.4285471205135,141795
100,2020-07-23,3983784,70150,69462.09683641384,142995,1200,925.7186981188621,142995
101,2020-07-24,4051800,68016,68492.51076393842,144106,1111,948.2840708710686,144106
102,2020-07-25,4126819,75019,67231.02365471981,145303,1197,972.164771830684,145303
103,2020-07-26,4193142,66323,65762.5840216997,146294,991,997.1755965436612,146294
104,2020-07-27,4250669,57527,64183.04362732645,146829,535,1022.8960445099879,146829
105,2020-07-28,4306738,56069,62590.74875037873,147926,1097,1048.685984488194,147926
106,2020-07-29,4370753,64015,61077.97714739473,149080,1154,1073.7257831892564,149080
107,2020-07-30,4438829,68076,59723.02043440765,150488,1408,1097.0773036400708,150488
108,2020-07-31,4507280,68451,58583.646566316704,151906,1418,1117.760127564226,151906
109,2020-08-01,4575704,68424,57692.54291047199,153119,1213,1134.8358495114403,153119
110,2020-08-02,4635877,60173,57055.15015619051,154262,1143,1147.4924668895032,154262
111,2020-08-03,4682289,46412,56650.06927855421,154727,465,1155.1208222304847,154727
112,2020-08-04,4728367,46078,56431.979773253915,155292,565,1157.3757436698168,155292
113,2020-08-05,4783751,55384,56336.770591170054,156572,1280,1154.2159080676963,156572
114,2020-08-06,4838995,55244,56288.37801542655,157993,1421,1145.9183865192706,157993
115,2020-08-07,4896371,57376,56206.66660862761,159776,1783,1133.0661418222592,159776
116,2020-08-08,4957742,61371,56015.595034225575,161074,1298,1116.5092163556758,161074
117,2020-08-09,5013793,56051,55650.886626031395,162153,1079,1097.3027484293455,162153
118,2020-08-10,5063017,49224,55066.476745713524,162725,572,1076.6270653848333,162725
119,2020-08-11,5108278,45261,54239.12990551225,163235,510,1055.6967308256546,163235
120,2020-08-12,5161168,52890,53170.7975319779,164341,1106,1035.6664252544233,164341
121,2020-08-13,5213490,52322,51888.5049606926,165844,1503,1017.5418265945098,165844
122,2020-08-14,5264929,51439,50441.79295026939,166890,1046,1002.1032080340799,166890
123,2020-08-15,5330009,65080,48897.97215886452,168200,1310,989.8483310384772,168200
124,2020-08-16,5380406,50397,47335.656553718196,169246,1046,980.9594892498465,169246
125,2020-08-17,5421270,40864,45837.204069578875,169850,604,975.2974141434154,169850
126,2020-08-18,5456359,35089,44480.79480760882,170314,464,972.4223822135232,170314
127,2020-08-19,5499385,43026,43332.90926615389,171532,1218,971.6404809716933,171532
128,2020-08-20,5542976,43591,42441.92875465228,172838,1306,972.0708106549858,172838
129,2020-08-21,5587507,44531,41833.4713698349,173944,1106,972.7276130715003,173944
130,2020-08-22,5637003,49496,41507.910268162705,175048,1104,972.610083358628,175048
131,2020-08-23,5682001,44998,41440.31243250156,176036,988,970.7920380910457,176036
132,2020-08-24,5716804,34803,41582.80557583388,176526,490,966.5037275724321,176526
133,2020-08-25,5752138,35334,41869.15011748717,176970,444,959.198871562361,176970
134,2020-08-26,5792924,40786,42221.084098633306,178205,1235,948.6013859840086,178205
135,2020-08-27,5835285,42361,42555.8411336305,179376,1171,934.7281209122949,179376
136,2020-08-28,5881532,46247,42794.13070835419,180503,1127,917.8860754379986,180503
137,2020-08-29,5928341,46809,42867.82658942301,181445,942,898.644797572891,181445
138,2020-08-30,5973893,45552,42726.636680080504,182428,983,877.786816588577,182428
139,2020-08-31,6008837,34944,42343.12352310174,182871,443,856.2408032871778,182871
140,2020-09-01,6043627,34790,41715.59957329761,183319,448,835.0035524421746,183319
141,2020-09-02,6087407,43780,40868.62059791144,184380,1061,815.0577160404215,184380
142,2020-09-03,6127152,39745,39851.02527279245,185436,1056,797.2924238269146,185436
143,2020-09-04,6164173,37021,38731.698081128205,186465,1029,782.4335042094274,186465
144,2020-09-05,6215262,51089,37593.444537729236,187442,977,770.9890156853961,187442
145,2020-09-06,6259233,43971,36525.54281094165,188275,833,763.2143192739283,188275
146,2020-09-07,6290547,31314,35615.65780233542,188709,434,759.0991090825094,188709
147,2020-09-08,6315064,24517,34941.86152665896,189020,311,758.3768408454723,189020
148,2020-09-09,6340490,25426,34565.492131201536,189483,463,760.5550374456557,189483
149,2020-09-10,6375681,35191,34525.50452932107,190611,1128,764.9631805658858,190611
150,2020-09-11,6410312,34631,34834.82615345866,191530,919,770.8134716142763,191530
151,2020-09-12,6458568,48256,35479.045079328935,192682,1152,777.2687808740618,192682
152,2020-09-13,6500846,42278,36417.5423373009,193434,752,783.5116745712982,193434
153,2020-09-14,6535779,34933,37586.955816104484,193828,394,788.8085379978119,193828
154,2020-09-15,6568719,32940,38906.65067987873,194249,421,792.5634705743576,194249
155,2020-09-16,6608192,39473,40285.69029802728,195455,1206,794.3577401342994,195455
156,2020-09-17,6646493,38301,41630.668869618334,196414,959,793.9720339840335,196414
157,2020-09-18,6691943,45450,42853.694132218785,197277,863,791.3903911141392,197277
158,2020-09-19,6741352,49409,43879.8020023698,198241,964,786.7863871747304,198241
159,2020-09-20,6784794,43442,44653.144689423534,198947,706,780.4937163016157,198947
160,2020-09-21,6824754,39960,45141.413562212125,199207,260,772.9646315859918,199207
161,2020-09-22,6875393,50639,45338.126086447606,199621,414,764.7206565921755,199621
162,2020-09-23,6915938,40545,45262.60634837674,200659,1038,756.3004887963059,200659
163,2020-09-24,6953517,37579,44957.702050275315,201719,1060,748.2100502722179,201719
164,2020-09-25,7001420,47903,44485.48738210198,202621,902,740.8792144319411,202621
165,2020-09-26,7054778,53358,43921.381670863615,203536,915,734.6289056120662,203536
166,2020-09-27,7100329,45551,43347.25166230659,204314,778,729.6511223206337,204314
167,2020-09-28,7139340,39011,42844.1483523734,204613,299,726.0030930588933,204613
168,2020-09-29,7171935,32595,42485.350410803745,204943,330,723.6153685614852,204943
169,2020-09-30,7216242,44307,42330.34428917327,205858,915,722.3123206803585,205858
170,2020-10-01,7256612,40370,42420.27090226611,206805,947,721.8423797865951,206805
171,2020-10-02,7302769,46157,42775.22058016776,207729,924,721.914501158652,207729
172,2020-10-03,7358162,55393,43393.57649142529,208555,826,722.2368769619801,208555
173,2020-10-04,7409200,51038,44253.40959930372,209250,695,722.5538378318282,209250
174,2020-10-05,7443947,34747,45315.73437328435,209614,364,722.6772114482859,209614
175,2020-10-06,7482538,38591,46529.26233864053,210089,475,722.5090820848889,210089
176,2020-10-07,7527937,45399,47836.15622575023,210796,707,722.0538497748387,210796
177,2020-10-08,7578063,50126,49178.20329503599,211706,910,721.4186209260263,211706
178,2020-10-09,7637139,59076,50502.799738173446,212679,973,720.8021600639341,212679
179,2020-10-10,7694152,57013,51768.17066226664,213645,966,720.4737778784522,213645
180,2020-10-11,7750083,55931,52947.33809519334,214299,654,720.7445149111709,214299
181,2020-10-12,7796893,46810,54030.4834505143,214743,444,721.9337122051231,214743
182,2020-10-13,7839136,42243,55025.51733171,215132,389,724.3344754939222,215132
183,2020-10-14,7890390,51254,55956.85178306785,215917,785,728.1816051960756,215917
184,2020-10-15,7949592,59202,56862.55005192526,216920,1003,733.6252817781594,216920
185,2020-10-16,8014943,65351,57790.18890916347,217752,832,740.7131991579489,217752
186,2020-10-17,8084164,69221,58791.89293951082,218681,929,749.3829908804709,218681
187,2020-10-18,8141904,57740,59919.0768877571,219471,790,759.4657802015447,219471
188,2020-10-19,8193061,51157,61217.45378779555,219893,422,770.7006049588955,219893
189,2020-10-20,8260165,67104,62722.83129584001,220373,480,782.7584241589312,220373
190,2020-10-21,8322085,61920,64458.13009395386,221309,936,795.273502703609,221309
191,2020-10-22,8384801,62716,66431.92537014632,222492,1183,807.8792760235162,222492
192,2020-10-23,8461142,76341,68638.64854403376,223331,839,820.2453779302397,223331
193,2020-10-24,8544430,83288,71060.4080142361,224277,946,832.1124060787362,224277
194,2020-10-25,8628319,83889,73670.21268438567,225221,944,843.3212040233126,225221
195,2020-10-26,8691501,63182,76436.22807960339,225645,424,853.8339321192673,225645
196,2020-10-27,8757728,66227,79326.57774744561,226145,500,863.744930998749,226145
197,2020-10-28,8835996,78268,82314.13461193438,227174,1029,873.280280420624,227174
198,2020-10-29,8914642,78646,85380.73558017507,228201,1027,882.7859393668549,228201
199,2020-10-30,9006320,91678,88520.30007876437,229213,1012,892.7053318669921,229213
200,2020-10-31,9106774,100454,91740.4356834211,230257,1044,903.5481320855083,230257
201,2020-11-01,9197557,90783,95062.26252018806,231207,950,915.8527275758642,231207
202,2020-11-02,9303323,105766,98518.3689439701,231702,495,930.145344369493,231702
203,2020-11-03,9387302,83979,102149.00703804054,232221,519,946.8990663714675,232221
204,2020-11-04,9515628,128326,105996.82881942591,233833,1612,966.4959627272455,233833
205,2020-11-05,9619184,103556,110100.63373362256,234982,1149,989.1952622870845,234982
206,2020-11-06,9749305,130121,114488.72788021764,236160,1178,1015.1100170776397,236160
207,2020-11-07,9877396,128091,119172.5716231088,237399,1239,1044.194026816341,237399
208,2020-11-08,10009912,132516,124141.40573864446,238540,1141,1076.2400154334457,238540
209,2020-11-09,10134210,124298,129358.49363881325,239092,552,1110.889224953302,239092
210,2020-11-10,10209733,75523,134759.5011481356,239849,757,1147.651787479018,239849
211,2020-11-11,10354834,145101,140253.364424435,241308,1459,1185.9365111460004,241308
212,2020-11-12,10504221,149387,145725.78476514714,242805,1497,1225.0881180504055,242805
213,2020-11-13,10666089,161868,151045.254193947,244173,1368,1264.4295340767615,244173
214,2020-11-14,10847215,181126,156071.27838186506,245372,1199,1303.3065690889857,245372
215,2020-11-15,11019459,172244,160664.24487549165,246745,1373,1341.1322423872325,246745
216,2020-11-16,11157216,137757,164696.20490142898,247532,787,1377.428090280429,247532
217,2020-11-17,11316341,159125,168061.7133747396,248342,810,1411.8600171430714,248342
218,2020-11-18,11480445,164104,170687.81684713063,250049,1707,1444.266588800873,250049
219,2020-11-19,11653747,173302,172542.2999969469,251991,1942,1474.6780853442617,251991
220,2020-11-20,11845577,191830,173639.39852097395,254032,2041,1503.325098581502,254032
221,2020-11-21,12047505,201928,174042.35404536474,255990,1958,1530.6359507352113,255990
222,2020-11-22,12229516,182011,173862.4129244242,257627,1637,1557.2227054056555,257627
223,2020-11-23,12376095,146579,173254.13836322833,258686,1059,1583.8560260501474,258686
224,2020-11-24,12547989,171894,172407.1932194847,259759,1073,1611.4296044632836,259759
225,2020-11-25,12725171,177182,171535.03607911005,261894,2135,1640.9153298597696,261894
226,2020-11-26,12910268,185097,170861.2325560997,264151,2257,1673.3107981031435,264151
227,2020-11-27,13028611,118343,170604.29578746902,265552,1401,1709.581169394052,265552
228,2020-11-28,13231677,203066,170962.11685373166,267106,1554,1750.5977664664895,267106
229,2020-11-29,13390420,158743,172097.1144464838,268464,1358,1797.0761529541248,268464
230,2020-11-30,13531226,140806,174123.21671078386,269515,1051,1849.5167244395623,269515
231,2020-12-01,13686970,155744,177095.68666089204,270827,1312,1908.151056590286,270827
232,2020-12-02,13881005,194035,181004.62244955607,273379,2552,1972.8973534661698,273379
233,2020-12-03,14085509,204504,185772.71779318253,276209,2830,2043.328289220917,276209
234,2020-12-04,14309670,224161,191257.5739237353,279178,2969,2118.6543038066225,279178
235,2020-12-05,14544983,235313,197258.53421958128,281790,2612,2197.724969888466,281790
236,2020-12-06,14766893,221910,203527.68988581304,284180,2390,2279.05037743242,284180
237,2020-12-07,14946112,179219,209784.40364216277,285583,1403,2360.843584223942,285583
238,2020-12-08,15136263,190151,215732.44062932848,287142,1559,2441.0840751356636,287142
239,2020-12-09,15367212,230949,221078.60062904522,289725,2583,2517.6009031222247,289725
240,2020-12-10,15588347,221135,225551.62743796653,292906,3181,2588.172816252418,292906
241,2020-12-11,15823022,234675,228920.1383108673,295892,2986,2650.6412936020365,295892
242,2020-12-12,16063279,240257,231008.3709486109,299273,3381,2703.0311201840045,299273
243,2020-12-13,16285443,222164,231708.68332264657,301806,2533,2743.6720375274185,301806
244,2020-12-14,16472147,186704,230989.9525112266,303465,1659,2771.3142219763604,303465
245,2020-12-15,16672776,200629,228901.28738305316,305114,1649,2785.2299669097706,305114
246,2020-12-16,16894828,222052,225570.77723188102,308101,2987,2785.2940570004625,308101
247,2020-12-17,17135514,240686,221199.32276746153,311834,3733,2772.0359714227807,311834
248,2020-12-18,17372721,237207,216049.9148382219,315284,3450,2746.6582498773405,315284
249,2020-12-19,17621693,248972,210433.0183591674,318226,2942,2711.0170687886457,318226
250,2020-12-20,17824263,202570,204688.96493456443,320980,2754,2667.563228691417,320980
251,2020-12-21,18009622,185359,199168.4420009316,322749,1769,2619.2442286070354,322749
252,2020-12-22,18199338,189716,194212.27795984267,324546,1797,2569.370743353676,324546
253,2020-12-23,18401293,201955,190131.75590495887,327844,3298,2521.453442431325,327844
254,2020-12-24,18627073,225780,187190.64276680935,331223,3379,2479.0184973669775,331223
255,2020-12-25,18831976,204903,185590.00083259496,334145,2922,2445.412122033172,334145
256,2020-12-26,18940661,108685,185456.66418500958,335650,1505,2423.6058982549225,335650
257,2020-12-27,19159654,218993,186836.0270622429,337563,1913,2416.015310567196,337563
258,2020-12-28,19314648,154994,189689.5207188915,339001,1438,2424.3437497778627,339001
259,2020-12-29,19481333,166685,193896.86795570576,340878,1877,2449.4632036081366,340878
260,2020-12-30,19683000,201667,199262.91838804958,344494,3616,2491.3409577887055,344494
261,2020-12-31,19905949,222949,205528.60026473907,348427,3933,2549.0189733760885,348427
262,2021-01-01,20164077,258128,212385.29191027215,351754,3327,2620.6493402593774,351754
263,2021-01-02,20330344,166267,219491.730590857,353948,2194,2703.585542351474,353948
264,2021-01-03,20626223,295879,226492.44835160964,356547,2599,2794.5254575291433,356547
265,2021-01-04,20829873,203650,233036.6588916111,357984,1437,2889.698329198402,357984
266,2021-01-05,21011519,181646,238796.5186375494,359964,1980,2985.0846635891703,359964
267,2021-01-06,21242773,231254,243483.74679354785,363568,3604,3076.6553860351187,363568
268,2021-01-07,21499615,256842,246863.70769416526,367492,3924,3160.614849370609,367492
269,2021-01-08,21788251,288636,248766.22563847556,371520,4028,3233.6315885692047,371520
270,2021-01-09,22091738,303487,249092.60649949784,375709,4189,3293.0411451222935,375709
271,2021-01-10,22351272,259534,247818.56906977194,378965,3256,3337.006847146843,378965
272,2021-01-11,22564648,213376,244993.0286957731,381069,2104,3364.627045886756,381069
273,2021-01-12,22775465,210817,240732.9125071435,382905,1836,3375.9808131188856,382905
274,2021-01-13,22994386,218921,235214.40629117723,387294,4389,3372.108262106801,387294
275,2021-01-14,23224228,229842,228661.22588691415,391312,4018,3354.9261766054656,391312
276,2021-01-15,23462271,238043,221330.66079510743,395104,3792,3327.0841928139157,395104
277,2021-01-16,23709211,246940,213498.24673006902,398916,3812,3291.7710425634505,398916
278,2021-01-17,23917843,208632,205441.98191627368,402493,3577,3252.4840122057344,402493
279,2021-01-18,24094518,176675,197427.0067329797,404484,1991,3212.777520760734,404484
280,2021-01-19,24235601,141083,189691.618421192,406049,1565,3176.008355708684,406049
281,2021-01-20,24399887,164286,182435.39542638103,408450,2401,3145.095488672157,408450
282,2021-01-21,24585281,185394,175810.0656527909,412892,4442,3122.3114817412093,412892
283,2021-01-22,24777591,192310,169913.57788629856,417029,4137,3109.1203409975265,417029
284,2021-01-23,24967120,189529,164787.63624402694,420806,3777,3106.0734237961997,420806
285,2021-01-24,25141997,174877,160418.7454414617,424362,3556,3112.7708915241783,424362
286,2021-01-25,25279828,137831,156742.60239330947,426220,1858,3127.8915180046097,426220
287,2021-01-26,25421949,142121,153651.46971698414,427990,1770,3149.2887584751134,427990
288,2021-01-27,25566731,144782,151003.9909883516,431972,3982,3174.146217071438,431972
289,2021-01-28,25721867,155136,148636.76667737123,436100,4128,3199.1813752270123,436100
290,2021-01-29,25889303,167436,146376.9121524666,439950,3850,3220.8829767874204,439950
291,2021-01-30,26055141,165838,144054.7710260818,443549,3599,3235.7650651558215,443549
292,2021-01-31,26200811,145670,141515.96147789113,446450,2901,3240.6195106370837,446450
293,2021-02-01,26316240,115429,138631.98984346635,448407,1957,3232.749035920882,448407
294,2021-02-02,26445632,129392,135308.7711751974,450184,1777,3210.164227973157,450184
295,2021-02-03,26559499,113867,131492.54395921112,453717,3533,3171.730700617696,453717
296,2021-02-04,26682606,123107,127172.84616071182,457634,3917,3117.256239492953,457634
297,2021-02-05,26806544,123938,122382.42044747727,461518,3884,3047.5121421545887,461518
298,2021-02-06,26938205,131661,117194.12444596447,465192,3674,2964.1877313613695,465192
299,2021-02-07,27049141,110936,111715.12319249367,467929,2737,2869.7818132583657,467929
300,2021-02-08,27141041,91900,106078.82182175749,469406,1477,2767.439319589574,469406
301,2021-02-09,27226044,85003,100435.14451697505,470857,1451,2660.7451877369313,470857
302,2021-02-10,27320646,94602,94939.87053477604,473922,3065,2553.4904206025053,473922
303,2021-02-11,27416458,95812,89743.79237441072,477328,3406,2449.427029514398,477328
304,2021-02-12,27522763,106305,84982.46109122333,480520,3192,2352.029084292067,480520
305,2021-02-13,27622811,100048,80767.2294506713,483404,2884,2264.2763570751094,483404
306,2021-02-14,27711665,88854,77178.19911721279,485700,2296,2188.4751270560646,485700
307,2021-02-15,27777996,66331,74259.53111090354,486898,1198,2126.12777586377,486898
308,2021-02-16,27832657,54661,72017.40025554429,487847,949,2077.8590854202066,487847
309,2021-02-17,27891261,58604,70420.6775849544,489491,1644,2043.4029429517675,489491
310,2021-02-18,27961316,70055,69404.22436758823,491937,2446,2021.6487833854076,491937
311,2021-02-19,28032685,71369,68874.49253864375,494544,2607,2010.7428848830234,494544
312,2021-02-20,28110871,78186,68716.96300695761,497079,2535,2008.2358862909591,497079
313,2021-02-21,28184282,73411,68804.82767091796,499012,1933,2011.2648805317388,499012
314,2021-02-22,28242170,57888,69008.24223736441,500239,1227,2016.7563581601505,500239
315,2021-02-23,28297003,54833,69203.45062120377,501440,1201,2021.635257222679,501440
316,2021-02-24,28369029,72026,69281.10922094189,503716,2276,2023.0254623388846,503716
317,2021-02-25,28444040,75011,69153.2178858698,506980,3264,2018.428246072449,506980
318,2021-02-26,28522097,78057,68758.18706895768,509410,2430,2005.8672386549458,509410
319,2021-02-27,28600831,78734,68063.7271912135,511565,2155,1983.9913600067036,511565
320,2021-02-28,28666895,66064,67067.42370747727,513085,1520,1952.1305118709913,513085
321,2021-03-01,28718761,51866,65795.045284521,514192,1107,1910.302437885431,514192
322,2021-03-02,28773252,54491,64296.80804196128,515512,1320,1859.1727365116462,515512
323,2021-03-03,28830270,57018,62641.97198872181,517445,1933,1799.9732894874003,517445
324,2021-03-04,28897467,67197,60912.26464951758,520026,2581,1734.387113109964,520026
325,2021-03-05,28965989,68522,59194.702447091615,521978,1952,1664.4096670281644,521978
326,2021-03-06,29032854,66865,57574.40743426251,523701,1723,1592.1978431168338,523701
327,2021-03-07,29092138,59284,56127.994326317625,525232,1531,1519.9181523436196,525232
328,2021-03-08,29134204,42066,54918.03351593212,525943,711,1449.6050477980739,525943
329,2021-03-09,29178539,44335,53988.98677679314,526648,705,1383.038951172498,526648
330,2021-03-10,29234333,55794,53364.87382898423,528432,1784,1321.6515291801402,528432
331,2021-03-11,29292571,58238,53048.77232116582,530004,1572,1266.4632808552049,530004
332,2021-03-12,29355473,62902,53024.094769747935,531578,1574,1218.0557593156789,531578
333,2021-03-13,29417547,62074,53257.43728557817,533009,1431,1176.577985258096,533009
334,2021-03-14,29471138,53591,53702.66903829323,534006,997,1141.7840291947932,534006
335,2021-03-15,29509994,38856,54305.838627758385,534538,532,1113.0965358930496,534538
336,2021-03-16,29564758,54764,55010.42100221297,535238,700,1089.6892900700998,535238
337,2021-03-17,29619140,54382,55762.41973715345,536499,1261,1070.580881091766,536499
338,2021-03-18,29678591,59451,56514.87388021842,537716,1217,1054.73116567985,537716
339,2021-03-19,29739099,60508,57231.39185981629,539364,1648,1041.1325449839824,539364
340,2021-03-20,29801135,62036,57888.439459848014,540410,1046,1028.8890064453656,540410
341,2021-03-21,29858153,57018,58476.23426964666,541183,773,1017.2773264747652,541183
342,2021-03-22,29893125,34972,58998.23337569025,541973,790,1005.78664644069,541973
343,2021-03-23,29942607,49482,59469.33189164611,542506,533,994.1346584394169,542506
344,2021-03-24,29995887,53280,59913.00536793551,543451,945,982.2606966239088,543451
345,2021-03-25,30083118,87231,60357.719016939955,544986,1535,970.2979575368354,544986
346,2021-03-26,30151093,67975,60832.98346623415,546344,1358,958.5287201176916,546344
347,2021-03-27,30228638,77545,61365.45608505113,547512,1168,947.3276831249609,547512
348,2021-03-28,30290855,62217,61975.46807641936,548326,814,937.0993021628992,548326
349,2021-03-29,30337215,46360,62674.303329679315,548776,450,928.2152499478149,548776
350,2021-03-30,30404512,67297,63462.471574410236,549430,654,920.9578449171132,549430
351,2021-03-31,30465949,61437,64329.114370855794,550355,925,915.4745390656004,550355
352,2021-04-01,30532921,66972,65252.56836205095,551456,1101,911.7474062652901,551456
353,2021-04-02,30612086,79165,66201.99717022867,552579,1123,909.5801357053194,552579
354,2021-04-03,30683935,71849,67139.90216394419,553480,901,908.6034383497389,553480
355,2021-04-04,30748182,64247,68025.24249424029,554251,771,908.2981520924185,554251
356,2021-04-05,30784528,36346,68816.84348274619,554540,289,908.033815182358,554540
357,2021-04-06,30858008,73480,69476.75391903975,555011,471,907.1191859407595,555011
358,2021-04-07,30919153,61145,69973.22809643562,555875,864,904.8602164295917,555875
359,2021-04-08,30994131,74978,70283.05518048182,558469,2594,900.6204067790204,558469
360,2021-04-09,31074392,80261,70393.031425785,559512,1043,893.8783109710893,559512
361,2021-04-10,31158729,84337,70300.46203363642,560422,910,884.2772355336837,560422
362,2021-04-11,31228021,69292,70012.67961273402,561146,724,871.6628383471738,561146
363,2021-04-12,31274462,46441,69545.66509787523,561431,285,856.1053346704501,561431
364,2021-04-13,31341417,66955,68921.94473124779,561883,452,837.9042667485373,561883
365,2021-04-14,31420568,79151,68168.00472782052,562760,877,817.5751904371309,562760
366,2021-04-15,31495884,75316,67311.50705084644,563696,936,795.8190670057425,563696
367,2021-04-16,31569789,73905,66378.60156481028,564601,905,773.476510291306,564601
368,2021-04-17,31650171,80382,65391.611031300745,565462,861,751.470226228204,565462
369,2021-04-18,31704332,54161,64367.31839346147,566170,708,730.7399062448216,566170
370,2021-04-19,31747215,42883,63316.01581241107,566499,329,712.1744320018403,566499
371,2021-04-20,31813388,66173,62241.38950520906,567003,504,696.5464757512724,567003
372,2021-04-21,31874309,60921,61141.22261620648,567850,847,684.4544252163589,567850
373,2021-04-22,31938130,63821,60008.8097325327,568739,889,676.2760393342883,568739
374,2021-04-23,32005123,66993,58834.90042721259,569684,945,672.1373928161138,569684
375,2021-04-24,32067488,62365,57609.93324228957,570446,762,671.8995575193325,570446
376,2021-04-25,32121683,54195,56326.291543254425,571210,764,675.1641793347436,571210
377,2021-04-26,32155657,33974,54980.3117138457,571504,294,681.2977348240145,571504
378,2021-04-27,32201329,45672,53573.802238304896,571977,473,689.4728915625255,571977
379,2021-04-28,32252062,50733,52114.886352521586,572653,676,698.7241476217412,572653
380,2021-04-29,32307150,55088,50618.05545323345,573647,994,708.0138779361354,573647
381,2021-04-30,32366064,58914,49103.40753331445,574540,893,716.3041429326156,574540
382,2021-05-01,32424233,58169,47595.13543504114,575348,808,722.6291726474965,575348
383,2021-05-02,32470876,46643,46119.414163260524,576093,745,726.1633592457857,576093
384,2021-05-03,32500951,30075,44701.90593893232,576414,321,726.2798786710314,576414
385,2021-05-04,32549722,48771,43365.14866240763,576887,473,722.5956986432876,576887
386,2021-05-05,32590522,40800,42126.11282655678,577799,912,714.9996715516812,577799
387,2021-05-06,32636200,45678,40994.20131742315,578612,813,703.6615917050743,578612
388,2021-05-07,32683181,46981,39969.92668425761,579439,827,689.0214346621258,579439
389,2021-05-08,32731231,48050,39044.43509727648,580263,824,671.7593983009159,580263
390,2021-05-09,32765807,34576,38199.961755746626,580898,635,652.7487322307012,580898
391,2021-05-10,32787895,22088,37411.20741657655,581137,239,632.9945771896132,581137
392,2021-05-11,32823059,35164,36647.52963851106,581536,399,613.5630508249282,581536
393,2021-05-12,32857120,34061,35875.755161289904,582236,700,595.5055370916739,582236
394,2021-05-13,32893313,36193,35063.350669971755,583034,798,579.7835098836844,583034
395,2021-05-14,32931842,38529,34181.645430153236,583824,790,567.1992179671411,583824
396,2021-05-15,32973708,41866,33208.78583767401,584456,632,558.3371748384493,584456
397,2021-05-16,33003316,29608,32132.120714412747,584985,529,553.5206578537392,584985
398,2021-05-17,33020753,17437,30949.765866318005,585249,264,552.7863756920524,585249
399,2021-05-18,33048524,27771,29671.172517997453,585643,394,555.8791842945465,585643
400,2021-05-19,33076326,27802,28316.619528255706,586423,780,562.2673089473757,586423
401,2021-05-20,33105813,29487,26915.654502975132,587107,684,571.1770656959446,587107
402,2021-05-21,33135678,29865,25504.61364265343,587791,684,581.6446746153831,587791
403,2021-05-22,33164233,28555,24123.443866746515,588426,635,592.5815230487483,588426
404,2021-05-23,33184802,20569,22812.123864417696,588910,484,602.848260225132,588910
405,2021-05-24,33198229,13427,21607.025568417797,589100,190,611.3324592515094,589100
406,2021-05-25,33222717,24488,20537.56918660681,589538,438,617.0243182594031,589538
407,2021-05-26,33245791,23074,19623.501653497307,590185,647,619.0850116655349,590185
408,2021-05-27,33270340,24549,18873.07194715157,591162,977,616.9028374288172,591162
409,2021-05-28,33297446,27106,18282.292259118592,592517,1355,610.133199501499,592517
410,2021-05-29,33319412,21966,17835.369489361205,593057,540,598.7196517125032,593057
411,2021-05-30,33332030,12618,17506.277070150674,593407,350,582.8946226334245,593407
412,2021-05-31,33339002,6972,17261.323954994612,593536,129,563.1599366982155,593536
413,2021-06-01,33345017,6015,17062.47703449035,593694,158,540.2487324618858,593694
414,2021-06-02,33366813,21796,16871.115470820903,594357,663,515.0717418002058,594357
415,2021-06-03,33383982,17169,16651.848570007394,594921,564,488.6520301310613,594921
416,2021-06-04,33403066,19084,16376.017975353727,595560,639,462.05312028087127,595560
417,2021-06-05,33420200,17134,16024.531795659932,596087,527,436.3058681630478,596087
418,2021-06-06,33434775,14575,15589.74068068364,596668,581,412.3394927577268,596668
419,2021-06-07,33440527,5752,15076.158152302067,596825,157,390.9217837694351,596825
420,2021-06-08,33455478,14951,14499.940954998194,597138,313,372.61274803306213,597138
421,2021-06-09,33468591,13113,13887.168820068913,597469,331,357.7348707775419,597469
422,2021-06-10,33487580,18989,13271.084670696026,597949,480,346.3618464492479,597949
423,2021-06-11,33501944,14364,12688.56375613024,598367,418,338.32618106003906,598367
424,2021-06-12,33526778,24834,12176.162527648847,598906,539,333.2445996119071,598906
425,2021-06-13,33535542,8764,11766.146608155335,599182,276,330.5588249389845,599182
426,2021-06-14,33540806,5264,11482.906525504464,599286,104,329.58813690167915,599286
427,2021-06-15,33552936,12130,11340.138346615251,599465,179,329.5892647018581,599465
428,2021-06-16,33563839,10903,11339.096366463333,599799,334,329.81867688625533,599799
429,2021-06-17,33576409,12570,11468.122837235795,600183,384,329.59224983822634,600183
430,2021-06-18,33587045,10636,11703.534941994305,600500,317,328.33761938562395,600500
431,2021-06-19,33608403,21358,12011.813818273995,601114,614,325.6352211365646,601114
432,2021-06-20,33616907,8504,12352.90769156782,601289,175,321.2450417872933,601289
433,2021-06-21,33621409,4502,12684.344346711905,601359,70,315.1173485065259,601359
434,2021-06-22,33633014,11605,12965.759185787652,601624,265,307.3870306187039,601624
435,2021-06-23,33643843,10829,13163.3934096722,601975,351,298.35256162458626,601975
436,2021-06-24,33656992,13149,13254.108333229702,602374,399,288.4418547571284,602374
437,2021-06-25,33670638,13646,13228.498270210946,602714,340,278.1683364204123,602714
438,2021-06-26,33695032,24394,13092.763171841925,603237,523,268.08131259903877,603237
439,2021-06-27,33703740,8708,12869.116415883647,603394,157,258.71509353634093,603394
440,2021-06-28,33708052,4312,12594.642330461762,603464,70,250.5413428898068,603464
441,2021-06-29,33722586,14534,12318.669034989007,603616,152,243.92873410781996,603616
442,2021-06-30,33729380,6794,12098.870389405734,603953,337,239.11326698431537,603953
443,2021-07-01,33745682,16302,11996.441629635927,604248,295,236.18158895551633,604248
444,2021-07-02,33760081,14399,12070.793396217507,604534,286,235.06847004827915,604534
445,2021-07-03,33789453,29372,12374.267818283362,604969,435,235.5683043374572,604969
446,2021-07-04,33794152,4699,12947.391380366698,605051,82,237.35926725869544,605051
447,2021-07-05,33797976,3824,13815.140289929608,605089,38,240.03765620371766,605089
448,2021-07-06,33806811,8835,14984.607628994814,605211,122,243.1590770686751,605211
449,2021-07-07,33830194,23383,16444.33503800292,605524,313,246.2825855543576,605524
450,2021-07-08,33852875,22681,18165.41642488441,605845,321,249.01369450001613,605845
451,2021-07-09,33871889,19014,20104.311632006116,606093,248,251.04233072236383,606093
452,2021-07-10,33919392,47503,22207.140240502664,606555,462,252.17234697754904,606555
453,2021-07-11,33927784,8392,24415.076029939555,606638,83,252.34001589311617,606638
454,2021-07-12,33938937,11153,26670.345926734833,606747,109,251.6199757965173,606747
455,2021-07-13,33972570,33633,28922.265588468203,606986,239,250.21826681492843,606986
456,2021-07-14,33998944,26374,31132.725023664756,607345,359,248.4532825217696,607345
457,2021-07-15,34032078,33134,33280.5748519659,607677,332,246.72656012021062,607677
458,2021-07-16,34062046,29968,35364.45466837681,608003,326,245.48624205567447,608003
459,2021-07-17,34139526,77480,37403.74199119561,608361,358,245.18668328651157,608361
460,2021-07-18,34151385,11859,39437.471371206644,608428,67,246.2479955361041,608428
461,2021-07-19,34171360,19975,41521.26283456019,608601,173,249.01928697140227,608601
462,2021-07-20,34223507,52147,43722.48925271395,608801,200,253.7489792425603,608801
463,2021-07-21,34264077,40570,46114.08537329841,609093,292,260.5649012661355,609093
464,2021-07-22,34314662,50585,48767.54028420733,609445,352,269.4659357087555,609445
465,2021-07-23,34369328,54666,51745.70611130033,609739,294,280.32591640211314,609739
466,2021-07-24,34488723,119395,55096.08915134291,610299,560,292.9093427744368,610299
467,2021-07-25,34513904,25181,58845.26108442477,610418,119,306.89739474280344,610418
468,2021-07-26,34539538,25634,62994.93885327624,610503,85,321.9217967744953,610503
469,2021-07-27,34626059,86521,67520.13945411168,610768,265,337.6033768791292,610768
470,2021-07-28,34694802,68743,72369.63263792956,611218,450,353.59175692832054,611218
471,2021-07-29,34764242,69440,77468.70683950726,611599,381,369.60252914000546,611599
472,2021-07-30,34843532,79290,82724.05059319048,611926,327,385.44852359086485,611926
473,2021-07-31,35031603,188071,88030.35315100175,612799,873,401.06232654480067,612799
474,2021-08-01,35064263,32660,93278.06284435844,612952,153,416.50801485867885,612952
475,2021-08-02,35107201,42938,98361.62594582574,613165,213,431.981051092093,613165
476,2021-08-03,35227411,120210,103187.4740197652,613526,361,447.7963456234052,613526
477,2021-08-04,35330610,103199,107681.04007131908,614110,584,464.3655382498004,614110
478,2021-08-05,35427279,96669,111792.1630694144,614643,533,482.165487571392,614643
479,2021-08-06,35538202,110923,115498.3801973972,615147,504,501.70069883160886,615147
480,2021-08-07,35793497,255295,118805.79426477295,616301,1154,523.4629060547816,616301
481,2021-08-08,35842571,49074,121747.42317862101,616549,248,547.8912135390948,616549
482,2021-08-09,35870455,27884,124379.16912843079,616663,114,575.3360845086146,616663
483,2021-08-10,36050118,179663,126773.76575942728,617169,506,606.0300592031383,617169
484,2021-08-11,36171292,121174,129013.25134423858,618033,864,640.0674355607091,618033
485,2021-08-12,36327655,156363,131180.65669289115,618813,780,677.3943193148461,618813
486,2021-08-13,36469774,142119,133351.67452323384,619825,1012,717.8095281264121,619825
487,2021-08-14,36699694,229920,135587.08422927596,620881,1056,760.975904480241,620881
488,2021-08-15,36749123,49429,137926.64096609195,621135,254,806.4407408778106,621135
489,2021-08-16,36791196,42073,140385.00601967672,621311,176,853.6633245940307,621311
490,2021-08-17,37010611,219415,142950.10820414225,622364,1053,902.0471268448578,622364
491,2021-08-18,37163450,152839,145584.10051386507,623392,1028,950.97392882214,623392
492,2021-08-19,37322073,158623,148226.8332357072,624567,1175,999.8372051273299,624567
493,2021-08-20,37479311,157238,150801.5268579463,626348,1781,1048.072357937728,626348
494,2021-08-21,37724960,245649,153222.11782687882,627826,1478,1095.1818730768198,627826
495,2021-08-22,37791527,66567,155401.5875788138,628364,538,1140.754093005237,628364
496,2021-08-23,37827906,36379,157260.48612544936,628534,170,1184.4749997568463,628534
497,2021-08-24,38065326,237420,158734.83579850683,629919,1385,1226.133096112831,629919
498,2021-08-25,38222448,157122,159782.65175379487,631341,1422,1265.618092064331,631341
499,2021-08-26,38391877,169429,160388.43949266203,632831,1490,1302.914583002322,632831
500,2021-08-27,38576316,184439,160565.21508325028,635052,2221,1338.092200713289,635052
501,2021-08-28,38819889,243573,160353.82411617768,636774,1722,1371.2938049276786,636774
502,2021-08-29,38881157,61268,159819.58945131654,637394,620,1402.7231630882552,637394
503,2021-08-30,38923471,42314,159046.5717841683,637665,271,1432.6332645090781,637665
504,2021-08-31,39182754,259283,158129.9570105792,639429,1764,1461.31597867511,639429
505,2021-09-01,39354028,171274,157167.26833301244,640872,1443,1489.0932584764478,640872
506,2021-09-02,39556341,202313,156249.22116703424,642906,2034,1516.309578919178,642906
507,2021-09-03,39731420,175079,155451.0831398977,645859,2953,1543.324862293047,645859
508,2021-09-04,39967014,235594,154825.36481867012,647827,1968,1570.5068363241642,647827
509,2021-09-05,40036399,69385,154396.5518325716,648433,606,1598.2216517081954,648433
510,2021-09-06,40080358,43959,154158.40574524426,648812,379,1626.8216774595724,648812
511,2021-09-07,40158424,78066,154074.12591917173,649402,590,1656.6296992628534,649402
512,2021-09-08,40423853,265429,154079.39928694963,651536,2134,1687.9192433971666,651536
513,2021-09-09,40606886,183033,154088.09406820688,653814,2278,1720.8913877083635,653814
514,2021-09-10,40766790,159904,154000.1024927552,657097,3283,1755.6491317384136,657097
515,2021-09-11,40995214,228424,153710.6303442357,659528,2431,1792.1710968177208,659528
516,2021-09-12,41064421,69207,153120.08758157163,660302,774,1830.2869247092756,660302
517,2021-09-13,41104220,39799,152143.66858637938,660615,313,1869.65715552497,660615
518,2021-09-14,41356276,252056,150719.72968790558,662809,2194,1909.7605211483387,662809
519,2021-09-15,41502458,146182,148816.17457458918,664736,1927,1949.8914406573788,664736
520,2021-09-16,41673036,170578,146434.23614221415,667502,2766,1989.170029586444,667502
521,2021-09-17,41828544,155508,143609.28022819888,670963,3461,2026.5661486028664,670963
522,2021-09-18,42037414,208870,140408.5308029832,673409,2446,2060.937966380665,673409
523,2021-09-19,42097895,60481,136925.9020795485,674324,915,2091.084274395501,674324
524,2021-09-20,42137416,39521,133274.3938584264,674648,324,2115.8084716250887,674648
525,2021-09-21,42332303,194887,129576.73661503891,677004,2356,2133.9908549132733,677004
526,2021-09-22,42453959,121656,125955.14032836762,679359,2355,2144.6647320450115,679359
527,2021-09-23,42587085,133126,122521.08953418213,682204,2845,2147.091039256546,682204
528,2021-09-24,42713558,126473,119366.12756935651,685471,3267,2140.825694765728,685471
529,2021-09-25,42890462,176904,116554.48470230972,687955,2484,2125.7739278660524,687955
530,2021-09-26,42941329,50867,114118.23545502426,688708,753,2102.226324643512,688708
531,2021-09-27,42989401,48072,112055.4353001838,689226,518,2070.872319018602,689226
532,2021-09-28,43158782,169381,110331.40781584143,691598,2372,2032.788279621169,691598
533,2021-09-29,43270161,111379,108883.05642082277,694158,2560,1989.3991049098606,694158
534,2021-09-30,43393578,123417,107625.7880518325,696770,2612,1942.4142112431798,696770
535,2021-10-01,43503534,109956,106462.38692377997,699566,2796,1893.7408259589379,699566
536,2021-10-02,43656413,152879,105292.98887041467,701701,2135,1845.3794117313269,701701
537,2021-10-03,43698901,42488,104025.19909361521,702439,738,1799.307682951081,702439
538,2021-10-04,43739479,40578,102583.37941632302,702916,477,1757.3608794579516,702916
539,2021-10-05,43894443,154964,100916.20773192696,704950,2034,1721.1166178356686,704950
540,2021-10-06,43991654,97211,99001.77578110229,706856,1906,1691.7926678530764,706856
541,2021-10-07,44102409,110755,96849.72680621354,709485,2629,1670.1653739912947,709485
542,2021-10-08,44202952,100543,94500.22012452899,711962,2477,1656.515186194045,711962
543,2021-10-09,44329423,126471,92019.81827163968,713795,1833,1650.6039606179081,713795
544,2021-10-10,44359865,30442,89494.69460816016,714164,369,1651.6864691987237,714164
545,2021-10-11,44396066,36201,87021.82591656427,714609,445,1658.5560838209922,714609
546,2021-10-12,44500535,104469,84699.03934454192,715786,1177,1669.6220694840488,715786
547,2021-10-13,44606902,106367,82614.90546608332,718138,2352,1683.013533077491,718138
548,2021-10-14,44728475,121573,80839.496253387,721362,3224,1696.7030244197654,721362
549,2021-10-15,44814853,86378,79416.9543847439,723503,2141,1708.6412438464126,723503
550,2021-10-16,44924651,109798,78360.6540548246,725326,1823,1716.8934063549975,725326
551,2021-10-17,44959269,34618,77651.48791874676,725798,472,1719.7676257055923,725798
552,2021-10-18,44990381,31112,77239.512467458,726224,426,1715.9262342368788,726224
553,2021-10-19,45095141,104760,77048.85332126451,728039,1815,1704.4722060989595,728039
554,2021-10-20,45176088,80947,76985.44420184649,730171,2132,1685.0047058920957,730171
555,2021-10-21,45267544,91456,76946.88054610598,733371,3200,1657.6400941425525,733371
556,2021-10-22,45346444,78900,76833.43995658556,735355,1984,1622.9973007631286,735355
557,2021-10-23,45441599,95155,76559.18047360146,737248,1893,1582.1491206746953,737248
558,2021-10-24,45470475,28876,76061.98962263862,737754,506,1536.543480636942,737754
559,2021-10-25,45487903,17428,75311.52840748863,737966,212,1487.9008750667806,737966
560,2021-10-26,45604266,116363,74314.19064314743,739435,1469,1438.095803528659,739435
561,2021-10-27,45672977,68711,73114.46489278345,741047,1612,1389.0310404197162,741047
562,2021-10-28,45773873,100896,71792.42046421084,743120,2073,1342.5138595455026,743120
563,2021-10-29,45851417,77544,70457.41015816646,744960,1840,1300.1429141888946,744960
564,2021-10-30,45944990,93573,69238.45622762924,746690,1730,1263.2133883521044,746690
565,2021-10-31,45976632,31642,68272.12670716789,747040,350,1232.6463933024124,747040
566,2021-11-01,46007627,30995,67688.98354722145,747259,219,1208.9465362642836,747259
567,2021-11-02,46123246,115619,67599.86390334174,748530,1271,1192.189316688473,748530
568,2021-11-03,46194338,71092,68083.3217043278,749807,1277,1182.037705784293,749807
569,2021-11-04,46278912,84574,69175.49866495805,751770,1963,1177.7851292833002,751770
570,2021-11-05,46360729,81817,70863.51394452997,752964,1194,1178.4202735783872,752964
571,2021-11-06,46456839,96110,73083.17282538445,755080,2116,1182.7078078918291,755080
572,2021-11-07,46489730,32891,75721.42070434548,755504,424,1189.2783495258523,755504
573,2021-11-08,46525045,35315,78623.54148874871,755665,161,1196.7208312755472,755665
574,2021-11-09,46637371,112326,81604.65706392078,756928,1263,1203.6708398344522,756928
575,2021-11-10,46717683,80312,84464.66715992929,758405,1477,1208.8894093921303,758405
576,2021-11-11,46812691,95008,87005.41577561719,760080,1675,1211.3280596060197,760080
577,2021-11-12,46868208,55517,89048.61557493282,760888,808,1210.1774141746948,760888
578,2021-11-13,47014749,146541,90452.93155384273,763405,2517,1204.8983614182982,763405
579,2021-11-14,47055752,41003,91128.6353638285,763902,497,1195.236257796982,763902
580,2021-11-15,47086100,30348,91048.39527727809,764074,172,1181.219981766264,764074
581,2021-11-16,47225229,139129,90253.05435614134,765382,1308,1163.1486021527653,765382
582,2021-11-17,47313124,87895,88851.64913888164,766700,1318,1141.568957618962,766700
583,2021-11-18,47424847,111723,87015.4007213642,768357,1657,1117.2475257570813,768357
584,2021-11-19,47535172,110325,84965.92920644747,769651,1294,1091.139616377797,769651
585,2021-11-20,47661030,125858,82958.45639765583,771426,1775,1064.3582251827802,771426
586,2021-11-21,47702669,41639,81261.22499767941,771777,351,1038.143941595514,771777
587,2021-11-22,47740579,37910,80132.7335529788,771913,136,1013.8362549616187,771913
588,2021-11-23,47891281,150702,79798.63026756048,773155,1242,992.8455949253779,773155
589,2021-11-24,47983952,92671,80430.20128445403,774472,1317,976.6246178551575,774472
590,2021-11-25,48095562,111610,82126.31850213483,776154,1682,966.6367339863859,776154
591,2021-11-26,48128268,32706,84900.48079528686,776544,390,964.319746624873,776544
592,2021-11-27,48179532,51264,88674.20694871126,776817,273,971.0427867501666,776817
593,2021-11-28,48204270,24738,93277.54775330736,777025,208,988.0554634407796,777025
594,2021-11-29,48245265,40995,98456.91803834103,777147,122,1016.4292501311942,777147
595,2021-11-30,48442621,197356,103889.8535507856,779116,1969,1056.9924787359812,779116
596,2021-12-01,48560043,117422,109205.72236720254,780561,1445,1110.2617705893244,780561
597,2021-12-02,48698505,138462,114010.91470156903,782522,1961,1176.3741242119872,782522
598,2021-12-03,48836835,138330,117916.64204426044,786323,3801,1255.025028464404,786323
599,2021-12-04,48990427,153592,120567.23095557671,787855,1532,1345.4187116535657,787855
600,2021-12-05,49051572,61145,121666.7208569017,788362,507,1446.2368393340325,788362
601,2021-12-06,49099151,47579,121001.67700728681,788523,161,1555.631549057967,788523
602,2021-12-07,49281488,182337,118458.40278763401,789905,1382,1671.2476306271217,789905
603,2021-12-08,49393338,111850,114033.1582513929,791514,1609,1790.2769616949383,791514
604,2021-12-09,49542739,149401,107834.53072566594,793228,1714,1909.5460922423683,793228
605,2021-12-10,49661145,118406,100077.71424739753,794649,1421,2025.6352980692209,794649
606,2021-12-11,49833439,172294,91071.08777455888,796764,2115,2135.0247007057087,796764
